   NO		textures/east.xpm
SO textures/south.xpm
WE          		 textures/west.xpm
EA textures/east.xpm
C 0,   0 ,0
F   50,   50,50
               111
111111111111111110
10000000N00000001
10110000000000001
10000000000000001
10110000000000001
10000000000000001
10110000000000001
10000000000000001
10110000000000001
11111111111111111

